1 1 1 1
3 u
15 18
16 18
17 18
WwwwwwwwwwwwwwwwwwwwwwwwwwwwwW
w                            w
w                            w
w                            w
w                            w
w                            w
w                            w
w                            w
w                            w
w                            w
w                            w
w                            w
w                            w
w                            w
w                            w
w                 S          w
w                 s          w
w                 s          w
w                            w
w                            w
w                            w
w                            w
w                            w
w                            w
w                            w
w                            w
w                            w
w                            w
w                            w
WwwwwwwwwwwwwwwwwwwwwwwwwwwwwW
