1 1 1 1
4 l
12 15
12 16
12 17
12 18
WwwwwwwwwwwwwwwwwwwwwwwwwwwwwW
w                            w
w                            w
w                            w
w                            w
w        w                   w
w        w                   w
w        w                   w
w        w                   w
w        w                   w
w        w     Ssss          w
w        w                   w
w        w                   w
w        w                   w
w        w                   w
w        wwwwwwwwwww         w
w                  w         w
w                  w         w
w                  w         w
w                  w         w
w                  w         w
w                  w         w
w                  w         w
w                  w         w
w                  w         w
w                  w         w
w                            w
w                            w
w                            w
WwwwwwwwwwwwwwwwwwwwwwwwwwwwwW
