1 1 1 1
4 u
14 14
15 14
15 15
14 15
WwwwwwwwwwwwwwwwwwwwwwwwwwwwwW
w                            w
w                            w
w                            w
w                            w
w                            w
w     wwwwww      wwwwww     w
w     w                w     w
w     w                w     w
w     w                w     w
w     w                w     w
w     w                w     w
w                            w
w                            w
w             Ss             w
w             ss             w
w                            w
w                            w
w     w                w     w
w     w                w     w
w     w                w     w
w     w                w     w
w     w                w     w
w     wwwwww      wwwwww     w
w                            w
w                            w
w                            w
w                            w
w                            w
WwwwwwwwwwwwwwwwwwwwwwwwwwwwwW
